  #####
###   #	
# @ # ###
# #   o #
#     # #
## #    #
 #A   ###
 ######