  #####
###   #
#oA@  #
### @o#
#o##@ #
# # o ##
#@ +@@o#
#   o  #
########